###########################################################  ##############    #####  ##########################################
#####  ####    ##############################     #####       ##########                  ######################################
####            #### ##########  ###   #####       ###        #########     ##             ###  ######### ##############  ######
####             ##   ####   #   ###    ####                 ##########    ##########       #       ####   ############    #####
###     #######      ####        ###     ###  ##          ###      ####  ############                ##    ############     ####
##   ############   #####         ##          ##          ###       #### ############          ##         ##############      ##
#   #####  ######    ####                                  #        ###  #######  ###          ##         ##############       #
#   ####    #####    #####                                     ##    ##   #####                ###        ############         #
      #    ######     ####    ##        #####                  ##    ##   #####                ####      ###########           #
        ##########           ####      ######                  ##   #########             ##  #####    ##########              #
#  ##  ######  ###           ####      ######          ##   ##       ######               ##########   #########               #
############         ##       ###      ######          ###  ###       ####                ##########    ########               #
############        ######    ####        ###   #       ###  #####    ###                ######  ###       ####    #    ####   #
############    ##  ######    #####        ##  #####    ###   ####   ####                 ####    ###      ###    ###  #########
##########      ##  ######   ##########         #####  ####   ###    ###   #               ###    ####### ####    ##############
##  #####   ####      ####   ##########          ####  ####   ####        ###               ###  ######## #####   ######   #####
##   ###    ###        ###    ######              ##   ####   ######      ###       #        ###########     #     ####     ####
##   ###    ##          ###    ####               ##   ####   ########    ###      ###        ##########            ##      ####
###  #                  #####                           ###      #####   ###     ########      #####  ###                # #####
#####     ###             ####             ###          ####      ####  ###     #########       ###    #####            ###  ###
######    #############     ###   ###      ####         #####      ###  ##    ############       ##    ####              #    ##
#######    #############      #  ####       #####          ###  #            ##############            ###                     #
########    #####  ######      #######       ####           ######           ##############           ###                      #
########     ###    #####      ########      ####           #######            #######               ####             #        #
## #####     ##     ######        #####      ####     ####   ######             #####                 ###            ###      ##
#   #####           #######        ####       ####    #####    ####     ##       ####       ##        ###           ####       #
##  #####           #######        #####      ####    #####     ###     ##        ##     #####        ###          ######       
###  #####  ###     #####         ######      ##      #####     ####                     #####         ##        ########       
#### #############   ####        ########            ######    ######    ###              ####               #   #####         #
##################   #######     #########     ###   #####   #########  #####  ###         ###              ###   ###         ##
############   ##    ########     #########  #####   #####   #####################         ###        ##   ####    ###        ##
###########         #########     ################   #####   ######################  #    #####       ##    ###    #####   #  ##
#########           ####   ###     ######   #######  ####    #    ####     ############   ####        ###    ##     ####  ###  #
##   ###    ##     ####     ####     ###       ####   ###   #      ##      ############     #    ### ######         ###    #   #
##   ###    ###    ####      ###      ##       ####   ##   ##      ##   ##############        ######  ######        ###        #
##    ###    ###    ####      ###     ###      #####  ##   ###         #############    ##    #####    ####        ####       ##
##    ###    #####  ####      #####    #####   ########## ######      #############    ###    #####    ####        ###       ###
##    ###    #######          #####     ####      ######## ######   ##########  ##    ####   #######  #####         ##      ####
##    ##     ######      #    ###        ####      ###      #####   #########         ####  ##############          ###   ######
###     #   ######      ###   ##         #####               #####   ########              ###############          #### ####  #
#####   ##########     ####              #####                ####   #######       ##      ##   ###########        #########    
######  ###########    ###      ###      ######     #         ####   #####        ###  #         ##    #####       #########    
### #        ########  ###      ####        ####   ###         ###    ####       #### ####              #####      #######      
###            ######  ###     ######       #########     ###          ###  ##  ####  ######      ###   #####        ####       
####                         #########     #########     #####          #   ########   #####     ####   #####         ##       #
####                ##       ##########   ##########     #####             ##########           ####   #####          ##      ##
##  ##             ####      ##  #######   #####  #       ###          #  ############         ###   ######           ###  #####
#   ##             ###      ##    #######   ###            #          ###############         ###   #######      ### ###########
#                           ##        ##    ##                         ########              ####   ########     #### ##########
#    #####             ##                                    ##        #######              ######    #######          #########
#    ######   #       ###                           ##       ##         ######               ######     #####          #########
#   #############      ##         ###              ####  #              #######      #         ####      ####           ########
   ###############               #####  ##        ###########           #########   ###         #    ##   ##     ##     ########
   ##### #########               #########    #  ############            ###############             ##          ##     ########
#  #############                  ########   ###############    ###   ##  ##############             ##                 ########
#  ##########                    #########  #####     #####    ####   ##################                                 #######
#    #######      ##            ######### #######      ###    #####  ####################                                ##### #
#     ######      ##          ##########  ########     ###   ######  ####################                         ##    #####   
#  ##  #####                 ##########    #######           ######  ############    ###       ##  #              ###  ######   
#  ##  ###                ##########         ###            ######     ########       ##       ######             ###  ######   
#                         ##########                 ###    ###        #######        ###       ######   ##        #  #######   
##                         ##   ####                 ###    ##         #######        ###  ##   ######  ###            #####    
####      ##                    ####                ###         ##   #########             ##     ###  ####            #####    
####      #######    ##         #####              ###          ###############            ###     ##  #####           #####   #
#     ##   ######   ###        ######              ##           #################     ###  ####        ######         ### #    #
      ##    #####    #         ######     ##          ###       ###################   ###   ########   ######        ###      ##
  ##                      ##              ######     ####       ###################         ######### #######        ####     ##
  ###                     ##              ########   ########   ##########      ##          ######### ###       ##   ######  ###
  ###                          ##   #    ##########     ######   #####  ##                 #########            ##   ###########
#                   ###        ##  ###   ##   ######    ######    ####           ####     ##########                ############
#       ##         ####   ##        #             ###  ########  #####           ####    ####### ####              ###     #####
##     ###   ##   ######  ##              ####     #################             ###    ####  #   ###      #      ####      ####
###   ###    ###########                  ######    ###############                    ####      ####     #####  #####      ####
###   ###   ############        ##         #####     #############                    #####      ###     ###############     ###
##   ####   #############       ##              #     ############                    ######    ###      ###############      ##
### ####     ################                   ####   ##########     ##     #  ##        ########       ################      #
#######        ##############                   ####   ##  #          ###   #######  ##    ######        #######  ###  ###     #
######     #    ### ########            ##      ###                  #### ########   ###   ######        ######    #    ####  ##
#####     ###   ##   ######           #####     ###                 ####  #######      ## ##########     #####          ########
#####     ##          ######  #      #######   ####    ##        #######    ####        ##############                     #####
######           ##   ##########     ###############   ##        #####       ###        #######  #####                      ####
### ###         #### ##########      ################  ###      #####        ###       #######    #####     ###                #
##   ###      ############           ###############    ##      #####                 ########    #######   ###                 
###   #####  ############        ##         #####              ######  ##            #########    ########              ##      
###   #####  ###########      ######                         ############  ##        ########    #########             ####     
##    #####   ########      #########                       ######  ###    #####     ########  ############            ######  #
#     ####    ######       #####  #####  ###                #####    #      ####      #  ####  #############           #########
#     ##       ####         ###    #########       ##        ###            ####          ###  #############           #########
#               ####                #######     ## ##                        ###  ##      ####    ##########       ###  ########
##              ####    ###     ##   ######    ###       ##                  ##   ###    ######    ########        ###  ########
###            #####    ####   ####  ######   ###       ####                 ##  ####   ########   ####      ##    ##   ##    ##
###           #####      #### #####   ###########      #####   ##                ###    ##############       ###               #
###           ####           #####      ##########      ####   ##     ####        #       ##  #########      ###               #
##            ####              ##       ########        ###          #######                  ########      ###    ##         #
#             ####               ##      ######      ##   ##           #######      ##           ##         ###    ########   ##
#     ##        ##        ##    ###        ###       ##   ###          ######   #   ##   #                  ###    #############
#     ##                 ###########                      ###           #####  ####     ###                #####   #############
##                        #############                    ##      #     ####  ####     ###               ######   ##### #######
#                               ########     ###                  ###    ####   ##       #             #######     ####   ######
#     ##         ###             ########    #####    ###          ##   ######                    ##  #######      ##### #######
##   ###        ####             #########    ####    ####             ########             ##    ##   ######      #############
########        ####             #########    ####    #####            ########      ##     ##            ###     ######### ####
########        ###              ######       ###       ####           ########      ##     ##             ###    ########   ###
#########                         ####       ####        ####         #########                 ###          ##  #########   ###
########   ###           #####    ###       ####        ######       ###########         ##    ####      ##   ######   ##   ####
########   ####      #########    ###       ####      ########      #############  #     ###   ####      ##   #####    ##  #####
######     ####      #########    ###      #####     ##########    ####### ##########     #     ###           ####    ###  #####
#####       #               ##   ####      #####    #####################   ###########         ###            #      ##   #####
#####                        #    ###     #######  ###  #################    ##########        ###    ####                 #####
###                     ##                 ##########    #######   ######    #########   ########     ####                  ####
##        #####        ####                ##########     #####     #####    #####  ##   ########     ###                    ###
##        ######  ##    ######            ########         ####     ##      #####         #######    ###               ##     ##
##        ##########    ######           ########           ###           #######           ##      ####   #           ####  ###
#   ##     ########        ###          ########            ###           #######                  #####  #######     ##########
#   ##      ######          ###    ##   #######             ###          ########       #           ###   #######  #############
#   ##      ####            ####   ###     ####            ###           ########      ###                #######  #############
#  ##        ##             ####   ###      ####           ###            ########      ##               ########    #####  ####
# ###                       ###     ###     ####           ##             ########                     ##########      ##     ##
   #           ##            #       ##            ##              ###    ########                     ######  ##              #
      #      ####   ##                             ##             #####   ####                         #####                   #
#   ####     ###    ##                                           #####              ###               #######                 ##
#######                       ##       #                         ###               #####              ###########        #######
#######                       ##      ####                       ##                #####    ##        ##############    ########
######           ##           #      ######                              ##         #####  ###        ###############  #########
######           ##          #      ###  ###                             ####         #######               ####################
######                   ######     ##    ##                             #####         ######                ###################
#######  ###            #########  ###                 ###    #      ## ######         #######              ####################
#############  ###    #################  #  ###############  ##################     # #########  ###############################