##   ########  ###################       ######################################   ######    ##   ##     ########## #############
#     ######    ####   #   #######               ################   #   ######     ####                   ####     #############
#     ######    ####        ########              ########   ###         #####      ###                    ##    #########   ###
#     #####  #  #####       ########               #######    ##         #####       ##                         #########    ###
#      ###  ###  #####      #######         ## ##    #####    ##         ###                                    ######       ###
       ###   ###  ####    #########        ### ##     ####         ##    ##                  ##      ######     #####       ####
       ####   ##  ####    #########      ####         ####        ###                        ###     #######    ####       #####
       ####   #   ####    ########     ######         ###         ##      ##                 ####       ####   #####      ######
#             ## ######   #######     #######          ##                ###                  ######     ###  #######      # ###
#             #########     #####     ##  ##           ##                ##                      ###         ########        ###
##   ##       #########      ##  #   ##                #        ###                       #       #          ########       ####
#    ###      #########          ####                        #######                   #####                 ##   ###      #####
#    ###     ##########          ####                       ########                  #####   ###            ##            #####
     ####  ##      ###          ###                        ##########               #######   ###                         ######
    ########                 #####           ##           ###  #######              #######   ###     ###              #### ####
    ########                 ######     ##   ###       #####    ########              #        ##    #####             ###   ###
    ########                 #######    ##    ###   #######     #########                           ######             ##    ###
#     ##    #####    ##      #######           ###########       ###########     ##                 #####              ##   ####
###         ######  ###      #######            #########        ###########     ##   ##           #####          ##  ####   ###
###            #######       #######            #########         #  #####      ###   #######   ########        ##########   ###
#         ##   ######                          ###########            ###     ####   ########   ########      #######        ###
         ####  ######                  #       ##########             ##      ###    #######   ####           #####          ###
         ##  ########   ##       #### ####    ######   #        ##    ##     ####     ###      ###              #            ###
#            ##############     #####  ###   ######      #   #####    ###    #######  ##      ####                   ##      ###
#            ##   ##########     #     ##    ######     ###  ######   ####  ########         #####             #     ###    ####
#       ##          ###########        ##       ###     ############  ###############       ###               ###    ##   ######
#      ###      #    #### #######         ##     ##     ### #######     #############      ###                ####   #    ######
#     ####     ####   ##   ######        ###     ##      #   #####       ########  ##     ####                 ######     ######
#      ###     ####        ###        ######     ###          ###         ######         ####          #        ######      ####
#              ###  ###    ##         ######      ########    ###      #   #####       #####         ####       #######       ##
#                  ####               #######     #########  ####    ####   #######   ######         ####       ########       #
##                #####               ######      ##############   #####    #######    ######                   ########       #
###        #     #####  ##           ######       #######  #####  #####      #####      ####                   #########      ##
#######   ####   ####   ##        #######          #####          #####      ####       ###      ##           ##########     ###
#######  #####    ##   ###    #  #######            #####                    ####       ###   #####      #####  #########    ###
######    ###     ### ####   ###########     ###     #####                   #####  #  ###   ######      #####   #########    ##
####      ###     ######### ############     ####    ######                  ############    ######       #####  ########     ##
###      #####   #########  ##############   ####    #########                ###########     ######      #######  ##        ###
###    ########   ########   ##############  ###     ##########      #####      ########       #######   ########           ####
####   ########   #####       ############           ############    ######      #######       ######## #########         ######
####      #####               ###########           ####  #######     ####       ########     ########   ########     ##########
####       ####               ##########        #######    ######     ###       ####  #############         ####  ##############
#####      ###        ###     ##########       ########    #####     ###        ###      ##########          ###  ##############
#######         ###   ###          #####  ##   ########    #####    ####       ####       #########  ####    ###  ##     #####  
#######        ####  #  #           ####  ###   ###  ##   ####     ####   ##   #####        ##############                      
#######       ###  ###   ####       ####   ###   #        ###  ########   #########          #############                     #
######      ####   ###  ######     #####   ####           ###  ########  #########            ###########          ##          #
#####       ##     ##  ########   ##############           ##  ####################           ##########           ###         #
###                    ########    ##############               #######################       ##########     ##    ###          
##    ##                ###        #### ##########               ######################        ##########    ##    ##   #####   
###  ####               ##         ###   #########        ##    #####################          ###########  ###        #######  
##########                        ####   #########       ####  ####################           ##################        ######  
##########   ##                  ####    #########        #########   ############            #######  #########                
#########    ##       ##      ######    #######        #   #######     ###########               ###    ####  ##               #
#### ####   ###     #####  ### #####    ######        ###   ####       ###########          #     ##     ##                   ##
###   ##   ###     ##########    ####                  ### ####    ##############          ###                                ##
##    ##   ###     ########       ####                  ######    ###############           #                     #####  ##   ##
##   ###    ###     ###            ##                    #####  #################                                 #########   ##
###  ####   ######  ##                         ##         ####  ###############                  #                #########  ###
###   ###   ######  ##      ##        ##      ###    ##  ####   ####  ########                 ####               ########   ###
###        ####### ###      ##        ###########   ###  ###    ###    ####                   #####               #####       ##
###       #######  ###                #################   #    ####    ###                   ###         ##                   ##
####      #####                        ###  ##########      #######                         ###         ###            ###     #
#####      ###                  ##      #    #########     #########                        ###          ##           #####    #
######                         ####          ##########   #####  ##     ###                 ####                     #######   #
######                       ######            ########   ####         ####                  ###                     #######   #
#####                    #  #######    ##       #######                ###     ##             ###                        ###   #
###          ##         ############   ###      #######                 #      ###        ##   ####  ##                        #
##         ####        #############  ####      ########                       ##         ##    ##########        ##          ##
#        ######       ####  ########  ###         ######                           ####  ##      ############     ##         ###
#        #######     #####  #######   ##     #     #####                           ########       ###########               ####
          ########   #############    ##    ###    ######       ##                  ########         #########             #####
               ####  #############    ###    #       #####      ##                   #######     ##   ###########           ####
#               ###    ###########    ###             ####       ##    ##             ######     ##    ##########      #    ####
###             ####    ##    #####          #     ######        ####  ##            ####                  ######     ###   ####
####  ####      ######           ##      ######   ####          #####                ###      ##           #####      ##   #####
#### #######   ########             #   ##############         ####    ##            ###     ###           ####  ##        #####
##    ######   ####  ###    ##     ###  ##############         ###    #####         ###       #        #######   ##        #####
##     #####   ##     ##    ###   ##### #############          ###    #####          #             ##########    ##       ######
##     #####                ###  #####   #######              ####   ####                          #########     ###     ####  #
###    ####   ##                 ###        ###               ####   ###    ###       ##                ####     ##      ###    
####   ####   ##                 ##                            ###  ####    #####     ##                 ###                    
######  ##          ##                                          ########    ########  ###          #     ####                   
######  ##          ###                                         #########  #########   ###        ###     ###      #            
######  ##          ####         ##  ##         #####           ####################    ##      #####     ###    ######        #
####### ##           ###     ##  ######         ##########          ################           ######    ####   #######     ####
#######                    ####     #              ########          #############           ########     ###    ######   ######
#######       ##          #####                     #######     #     ###########           #########     ####   ###  ##  ######
########     #####         #####                     #  ####   ###     ###########     ##   #########    ####    ###  ##      ##
##########   ######           #####                      ##  #####     #############  ###      ####  ######       ##           #
##########   ########   ##     ######                        #####     #############   ##       ##   #####         ##  #       #
###          ########  ####        ###                       #####     ############                  ####          ######      #
##          #########  ####  ###    ###    ##               ######    ######  ####                            #   #  ####      #
#         ###########   ##  #####    ##    ##         ##   #######    ##       ###                     #     ######   ####    ##
          ##########       ########                  ###   #######              #           ##        ###   ########   ###   ###
          #########       ##########                  ##  #########                        ####       ##############       #####
     #    #########      ##########                       ##########         ##      ##    ####        #####              ######
#   ###  ##########     ##########                         ##########       ###      ##     ###         ###      #        ######
######## #########    ############           #    ##          ###  ##      ###        ##   ####         ###     ###        #####
#######   #######     #########     ###     #########               ##     ###         ########        ###       #   #      ####
#####       ####          ####      ####    ##########              ##      ##         ########       ###           ###     ####
####        ####           ##        ####     #######                       ###          ###        ####   ####      #         #
###         #####          ##        #####       ####          ####         ##                      ###    ####                #
##          #####         ###        #####        ##          ######                        ###      #     ####                #
###            #   ##     ####      #####   ###           ##########                        ###             ###       #####   ##
###                ###      #      ####     ###           ##########               ##        #        ##    ####   #############
###      #          #            #####                   ###########               ##                ####     #    #############
###     ###        #            ######                   ############       ##                        ###          ######    ###
##     ######     ##     ##     ######               ##   ##########       #######       ##                   ##   #####      ##
##  #   #  ###    ##     ##     #####                ###        ####       #######      #####                ###    ####       #
## ###      ##        #      ########      ###  ##    ###        ##       ########      ######             ######  ######      #
### ####             #####   ########      ########    ###               #########         ####       #    ################    #
##   ###    #        ###### #####          ########    ####     ##      #######       ###   ###      ###   ##########    ##   ##
#    ##    ###       #####  ####           #######    ############      ####          ###   ####    ####   ##  #####           #
     ##     #   ##    ###    ###           ######     ############      ###          ###     ####  ###          ####           #
                ###    ##    ####          ######    #####  ######     ###         ####       #######            #            ##
#                ###        #####     #    ######     ####  #######   ####         ####        ######                       ####
      ##          ##        ####     ###   #####      ####  ##  ###   #####         ###   ##  ########     #####            ####
     ####                   ####     ###   ####       ####            ######             ########################          #####
#    ########               ####      #    ###        #####          ######           #####################  #####     #########
##   ########   ##          #####         ####          ####       ######        ##  #####################    #####    #########
############## ###          #########    ######     ##   ###       #####        ##############  #######       #####   ##########
###################    ###     #######  ######     ####  ##        ###    ##    ########  ###    #####       ###################
####################   ####     ######  ##         ####       #     #     ##    #######          #####     #####################
###### #############    ###      # ######          ####      ###          #     ##  ##          ######    ######################
######  ###########                #######           #      ###       ####                     #######    ######################
###################              ##########   #          ######      ######        #      #   #########  ##############    #####
######################  ####    ################  #############################   #####################################    #####